- - - - W - -
- W - - W - W
- - - W W - -
W W - W - - -
- - - - - W -
- - W W - - G